{
  "tiles": [
    [
      {
        "type": "Forest",
        "x": [
          0, 1, 2, 3, 4, 5, 6, 7, 9, 10, 11, 12, 13, 14, 15, 0, 1, 2, 3, 14, 15,
          0, 1, 14, 15, 0, 14, 15, 11, 12, 13, 14, 15, 10, 11, 12, 13, 10, 11,
          0, 0, 1, 0, 1, 2, 0, 1, 2, 15, 0, 1, 15, 6, 14, 15, 4, 5, 6, 14, 15,
          3, 4, 5, 13, 14, 15, 2, 3, 13, 14, 15
        ],
        "y": [
          0, 0, 0, 0, 0, 0, 0, 0, 0, 0, 0, 0, 0, 0, 0, 1, 1, 1, 1, 1, 1, 2, 2,
          2, 2, 3, 3, 3, 4, 4, 4, 4, 4, 5, 5, 5, 5, 6, 6, 7, 8, 8, 9, 9, 9, 10,
          10, 10, 10, 11, 11, 11, 12, 12, 12, 13, 13, 13, 13, 13, 14, 14, 14,
          14, 14, 14, 15, 15, 15, 15, 15
        ]
      },
      {
        "type": "Road",
        "x": [
          8, 7, 8, 6, 7, 5, 5, 6, 6, 7, 7, 8, 13, 14, 15, 7, 8, 9, 10, 11, 12,
          13, 4, 5, 6, 7, 8, 3, 4, 8, 3, 8, 1, 2, 3, 8, 0, 1, 8, 0, 7, 8, 6, 7
        ],
        "y": [
          0, 1, 1, 2, 2, 3, 4, 4, 5, 6, 7, 7, 7, 7, 7, 8, 8, 8, 8, 8, 8, 8, 9,
          9, 9, 9, 9, 10, 10, 10, 11, 11, 12, 12, 12, 12, 13, 13, 13, 14, 14,
          14, 15, 15
        ]
      },
      {
        "type": "Plains",
        "x": [
          4, 5, 6, 9, 10, 11, 12, 2, 3, 4, 5, 9, 10, 11, 12, 13, 1, 2, 3, 4, 7,
          8, 9, 10, 11, 12, 13, 0, 1, 2, 3, 7, 8, 9, 10, 0, 2, 3, 4, 5, 7, 8, 9,
          14, 15, 0, 1, 2, 3, 4, 5, 8, 9, 12, 13, 15, 1, 2, 3, 4, 5, 6, 10, 11,
          12, 2, 3, 4, 5, 6, 14, 15, 3, 10, 11, 12, 13, 14, 15, 5, 6, 9, 10, 11,
          12, 13, 14, 2, 5, 6, 7, 9, 10, 11, 13, 14, 0, 4, 5, 7, 9, 10, 11, 12,
          13, 2, 3, 7, 9, 10, 11, 12, 13, 1, 2, 6, 10, 11, 12, 1, 4, 8, 9, 10,
          11, 12
        ],
        "y": [
          1, 1, 1, 1, 1, 1, 1, 2, 2, 2, 2, 2, 2, 2, 2, 2, 3, 3, 3, 3, 3, 3, 3,
          3, 3, 3, 3, 4, 4, 4, 4, 4, 4, 4, 4, 5, 5, 5, 5, 5, 5, 5, 5, 5, 5, 6,
          6, 6, 6, 6, 6, 6, 6, 6, 6, 6, 7, 7, 7, 7, 7, 7, 7, 7, 7, 8, 8, 8, 8,
          8, 8, 8, 9, 9, 9, 9, 9, 9, 9, 10, 10, 10, 10, 10, 10, 10, 10, 11, 11,
          11, 11, 11, 11, 11, 11, 11, 12, 12, 12, 12, 12, 12, 12, 12, 12, 13,
          13, 13, 13, 13, 13, 13, 13, 14, 14, 14, 14, 14, 14, 15, 15, 15, 15,
          15, 15, 15
        ]
      },
      {
        "type": "House",
        "x": [13, 8, 6, 4, 1, 6, 14, 9, 9, 7, 4, 12, 9, 0, 5],
        "y": [1, 2, 3, 4, 5, 6, 6, 7, 9, 10, 11, 11, 14, 15, 15]
      }
    ]
  ]
}
